1111111111111111
1111111111111111
1000000000001111
10E100C0000C1111
1000011111001111
1P0011E000C01111
1000000000001111
10000000P0001111
1111111111111111