1111111111111111111111111111111111
1E0000000000000C00000C000000000001
1010010100100000101001000000010101
1010010010101010001001000000010101
1P0000000C00C0000000000000000000C1
1000000000001100000000011CCCCCC001
100000000000000000E000000000000011
1111110000000011111000000111001111
1111110000001111111110000111C01111
11111100000011111111100C0111001111
1111111111111111111111111111111111