1111711
10000000
1111111
1000C001
11111111