111111
100E11
110001
1C01C1
1000P1
111111